SSSSSSSSSS
SEEEEEEEES
SEEESEEEES
SEEEEEEEES
SEEEEEEEES
SEEEEEEEES
SEEEEEEEES
SEEEEEEEES
SEEEEEEEES
SSSSSSSSSS