SSSSSSSSSS
SEEEEEEEES
SEEESEEEES
SEEESEEEES
SEEESEEEES
SEEEEEEEES
SEEEWEEEES
SEEEWEEEES
SEEEWEEBES
SSSSSSSSSS