SSSSSSSSSS
SEEEWEBEES
SEEEWEBEES
SEEEWEBEEE
SSSSSEEEEE
SEEEEEEEEE
SEEEEEEEEE
SEEEEEEEES
SEEEEEEEES
SSSSSSSSSS