SSSSSSSSSS
SSWSSSSSSS
SSWSSBSSSS
SSSSSSSSSS
SSSSBSSSSS
SSSSSSSWSS
SSSSSSBSSS
SSBSSSSSSS
SSSSSWSSSS
SSSSSSSSSS