SSSSSSSSSS
SEBEWEBEES
SWWWWWWWWS
SEBEWEBEES
SBBBBBBBBS
SEBEWEBEES
SWWWWWWWWS
SEBEWEBEES
SEBEWEBEES
SSSSSSSSSS