SSSSSSSSSS
SEWEEEEWES
SBEWEEBWWS
SEBEWEEBES
SEEBEWEEES
SEEEBEWEES
SEBEEBEWES
SWWBEEBEWS
SEWEEEEBES
SSSSSSSSSS