SSSSSSSSSS
SEEWEEBEES
SEEWEEBEES
SSSSEEBEES
SEEEEEEEES
SWWWWWWWWS
SEEEEEEEES
SEEBBBBEES
SEEEEEEEES
SSSSSSSSSS