SSSSSSSSSS
SEEBBEEWES
SEBBBEWEES
SBBBBWWEES
SBBBBWEEES
SEEWWWEEES
SEWWEEWEES
SWEEEEEWES
SEEEEEEEES
SSSSSSSSSS